Kirjuta oma nimi: Mariia Posvystak
SQL - Structure query language - структурный язык програмирования
DDL - Data definition language - язык определения данных
DML - Data definition language - язык управления данных
Database - andmebaas
Database management system - andmebaasi haldussüsteem
Related table - seotud tabletid
Relational database - relatiivne andmebaas
Relationship - seos
--------------------------------
Primary Key - Первичный ключ - Esmane võti
Foreign Key - Внешний ключ - Välisvõti
One-to-many relationship - отношения один ко многим - Üks-mitmele suhted 
One-to-one relationship - отношение один к одному - Üks-ühele suhe
Query - запрос - päring
Report - отчет - aruanne
Form - бланк - vorm
Data type / - andmetüüp
varchar - поле сменых символов
char 
int - числа - arv
decimal - числа с цифрой после комы - ujukomaarv
text - текст
bit, bool - логическая ошибка "0", "1"
date - дата
time - время
blob
--------------------------
Constraints - Piirangud

NOT NULL - põllul peavad olema sümbolid
UNIQUE - servas sõna või millegi nime ei tohi korrata
PRIMARY KEY - Первичный ключ - Esmane võti
FOREIGN KEY - Внешний ключ - Välisvõti
CHECK -  piirata veergu paigutatavate väärtuste vahemikku.
DEFAULT - määrab veeru vaikeväärtuse.
CREATE INDEX - indeksite loomine tabelites.
